"Name","Execution Time","Execution Time since last Reset","Execution Time since Start","Nr of Executions since last Reset","Nr of Executions since Start","NodeID","Classname"
"Random Forest Learner",202,202,163263,1,1051,"0:21","org.knime.base.node.mine.treeensemble2.node.learner.classification.TreeEnsembleClassificationLearnerNodeModel"
"Random Forest Learner",176,176,163439,1,1052,"0:21","org.knime.base.node.mine.treeensemble2.node.learner.classification.TreeEnsembleClassificationLearnerNodeModel"
"Random Forest Learner",167,167,163606,1,1053,"0:21","org.knime.base.node.mine.treeensemble2.node.learner.classification.TreeEnsembleClassificationLearnerNodeModel"
"Random Forest Learner",181,181,163787,1,1054,"0:21","org.knime.base.node.mine.treeensemble2.node.learner.classification.TreeEnsembleClassificationLearnerNodeModel"
"Random Forest Learner",190,190,163977,1,1055,"0:21","org.knime.base.node.mine.treeensemble2.node.learner.classification.TreeEnsembleClassificationLearnerNodeModel"
"Random Forest Learner",177,177,164154,1,1056,"0:21","org.knime.base.node.mine.treeensemble2.node.learner.classification.TreeEnsembleClassificationLearnerNodeModel"
"Random Forest Learner",203,203,164357,1,1057,"0:21","org.knime.base.node.mine.treeensemble2.node.learner.classification.TreeEnsembleClassificationLearnerNodeModel"
"Random Forest Learner",175,175,164532,1,1058,"0:21","org.knime.base.node.mine.treeensemble2.node.learner.classification.TreeEnsembleClassificationLearnerNodeModel"
"Random Forest Learner",170,170,164702,1,1059,"0:21","org.knime.base.node.mine.treeensemble2.node.learner.classification.TreeEnsembleClassificationLearnerNodeModel"
"Random Forest Learner",167,167,164869,1,1060,"0:21","org.knime.base.node.mine.treeensemble2.node.learner.classification.TreeEnsembleClassificationLearnerNodeModel"
"Random Forest Learner",170,170,165039,1,1061,"0:21","org.knime.base.node.mine.treeensemble2.node.learner.classification.TreeEnsembleClassificationLearnerNodeModel"
"Random Forest Learner",162,162,165201,1,1062,"0:21","org.knime.base.node.mine.treeensemble2.node.learner.classification.TreeEnsembleClassificationLearnerNodeModel"
"Random Forest Learner",187,187,165388,1,1063,"0:21","org.knime.base.node.mine.treeensemble2.node.learner.classification.TreeEnsembleClassificationLearnerNodeModel"
"Random Forest Learner",183,183,165571,1,1064,"0:21","org.knime.base.node.mine.treeensemble2.node.learner.classification.TreeEnsembleClassificationLearnerNodeModel"
"Random Forest Learner",198,198,165769,1,1065,"0:21","org.knime.base.node.mine.treeensemble2.node.learner.classification.TreeEnsembleClassificationLearnerNodeModel"
"Random Forest Learner",163,163,165932,1,1066,"0:21","org.knime.base.node.mine.treeensemble2.node.learner.classification.TreeEnsembleClassificationLearnerNodeModel"
"Random Forest Learner",167,167,166099,1,1067,"0:21","org.knime.base.node.mine.treeensemble2.node.learner.classification.TreeEnsembleClassificationLearnerNodeModel"
"Random Forest Learner",190,190,166289,1,1068,"0:21","org.knime.base.node.mine.treeensemble2.node.learner.classification.TreeEnsembleClassificationLearnerNodeModel"
"Random Forest Learner",188,188,166477,1,1069,"0:21","org.knime.base.node.mine.treeensemble2.node.learner.classification.TreeEnsembleClassificationLearnerNodeModel"
"Random Forest Learner",166,166,166643,1,1070,"0:21","org.knime.base.node.mine.treeensemble2.node.learner.classification.TreeEnsembleClassificationLearnerNodeModel"
"Random Forest Learner",187,187,166830,1,1071,"0:21","org.knime.base.node.mine.treeensemble2.node.learner.classification.TreeEnsembleClassificationLearnerNodeModel"
"Random Forest Learner",164,164,166994,1,1072,"0:21","org.knime.base.node.mine.treeensemble2.node.learner.classification.TreeEnsembleClassificationLearnerNodeModel"
"Random Forest Learner",164,164,167158,1,1073,"0:21","org.knime.base.node.mine.treeensemble2.node.learner.classification.TreeEnsembleClassificationLearnerNodeModel"
"Random Forest Learner",193,193,167351,1,1074,"0:21","org.knime.base.node.mine.treeensemble2.node.learner.classification.TreeEnsembleClassificationLearnerNodeModel"
"Random Forest Learner",165,165,167516,1,1075,"0:21","org.knime.base.node.mine.treeensemble2.node.learner.classification.TreeEnsembleClassificationLearnerNodeModel"
"Random Forest Learner",174,174,167690,1,1076,"0:21","org.knime.base.node.mine.treeensemble2.node.learner.classification.TreeEnsembleClassificationLearnerNodeModel"
"Random Forest Learner",153,153,167843,1,1077,"0:21","org.knime.base.node.mine.treeensemble2.node.learner.classification.TreeEnsembleClassificationLearnerNodeModel"
"Random Forest Learner",169,169,168012,1,1078,"0:21","org.knime.base.node.mine.treeensemble2.node.learner.classification.TreeEnsembleClassificationLearnerNodeModel"
"Random Forest Learner",159,159,168171,1,1079,"0:21","org.knime.base.node.mine.treeensemble2.node.learner.classification.TreeEnsembleClassificationLearnerNodeModel"
"Random Forest Learner",163,163,168334,1,1080,"0:21","org.knime.base.node.mine.treeensemble2.node.learner.classification.TreeEnsembleClassificationLearnerNodeModel"
"Random Forest Learner",161,161,168495,1,1081,"0:21","org.knime.base.node.mine.treeensemble2.node.learner.classification.TreeEnsembleClassificationLearnerNodeModel"
"Random Forest Learner",193,193,168688,1,1082,"0:21","org.knime.base.node.mine.treeensemble2.node.learner.classification.TreeEnsembleClassificationLearnerNodeModel"
"Random Forest Learner",170,170,168858,1,1083,"0:21","org.knime.base.node.mine.treeensemble2.node.learner.classification.TreeEnsembleClassificationLearnerNodeModel"
"Random Forest Learner",181,181,169039,1,1084,"0:21","org.knime.base.node.mine.treeensemble2.node.learner.classification.TreeEnsembleClassificationLearnerNodeModel"
"Random Forest Learner",195,195,169234,1,1085,"0:21","org.knime.base.node.mine.treeensemble2.node.learner.classification.TreeEnsembleClassificationLearnerNodeModel"
"Random Forest Learner",169,169,169403,1,1086,"0:21","org.knime.base.node.mine.treeensemble2.node.learner.classification.TreeEnsembleClassificationLearnerNodeModel"
"Random Forest Learner",178,178,169581,1,1087,"0:21","org.knime.base.node.mine.treeensemble2.node.learner.classification.TreeEnsembleClassificationLearnerNodeModel"
"Random Forest Learner",197,197,169778,1,1088,"0:21","org.knime.base.node.mine.treeensemble2.node.learner.classification.TreeEnsembleClassificationLearnerNodeModel"
"Random Forest Learner",180,180,169958,1,1089,"0:21","org.knime.base.node.mine.treeensemble2.node.learner.classification.TreeEnsembleClassificationLearnerNodeModel"
"Random Forest Learner",166,166,170124,1,1090,"0:21","org.knime.base.node.mine.treeensemble2.node.learner.classification.TreeEnsembleClassificationLearnerNodeModel"
"Random Forest Learner",203,203,170327,1,1091,"0:21","org.knime.base.node.mine.treeensemble2.node.learner.classification.TreeEnsembleClassificationLearnerNodeModel"
"Random Forest Learner",175,175,170502,1,1092,"0:21","org.knime.base.node.mine.treeensemble2.node.learner.classification.TreeEnsembleClassificationLearnerNodeModel"
"Random Forest Learner",161,161,170663,1,1093,"0:21","org.knime.base.node.mine.treeensemble2.node.learner.classification.TreeEnsembleClassificationLearnerNodeModel"
"Random Forest Learner",193,193,170856,1,1094,"0:21","org.knime.base.node.mine.treeensemble2.node.learner.classification.TreeEnsembleClassificationLearnerNodeModel"
"Random Forest Learner",167,167,171023,1,1095,"0:21","org.knime.base.node.mine.treeensemble2.node.learner.classification.TreeEnsembleClassificationLearnerNodeModel"
"Random Forest Learner",172,172,171195,1,1096,"0:21","org.knime.base.node.mine.treeensemble2.node.learner.classification.TreeEnsembleClassificationLearnerNodeModel"
"Random Forest Learner",171,171,171366,1,1097,"0:21","org.knime.base.node.mine.treeensemble2.node.learner.classification.TreeEnsembleClassificationLearnerNodeModel"
"Random Forest Learner",155,155,171521,1,1098,"0:21","org.knime.base.node.mine.treeensemble2.node.learner.classification.TreeEnsembleClassificationLearnerNodeModel"
"Random Forest Learner",143,143,171664,1,1099,"0:21","org.knime.base.node.mine.treeensemble2.node.learner.classification.TreeEnsembleClassificationLearnerNodeModel"
"Random Forest Learner",171,171,171835,1,1100,"0:21","org.knime.base.node.mine.treeensemble2.node.learner.classification.TreeEnsembleClassificationLearnerNodeModel"
"Random Forest Learner",164,164,171999,1,1101,"0:21","org.knime.base.node.mine.treeensemble2.node.learner.classification.TreeEnsembleClassificationLearnerNodeModel"
"Random Forest Learner",174,174,172173,1,1102,"0:21","org.knime.base.node.mine.treeensemble2.node.learner.classification.TreeEnsembleClassificationLearnerNodeModel"
"Random Forest Learner",173,173,172346,1,1103,"0:21","org.knime.base.node.mine.treeensemble2.node.learner.classification.TreeEnsembleClassificationLearnerNodeModel"
"Random Forest Learner",187,187,172533,1,1104,"0:21","org.knime.base.node.mine.treeensemble2.node.learner.classification.TreeEnsembleClassificationLearnerNodeModel"
"Random Forest Learner",154,154,172687,1,1105,"0:21","org.knime.base.node.mine.treeensemble2.node.learner.classification.TreeEnsembleClassificationLearnerNodeModel"
"Random Forest Learner",170,170,172857,1,1106,"0:21","org.knime.base.node.mine.treeensemble2.node.learner.classification.TreeEnsembleClassificationLearnerNodeModel"
"Random Forest Learner",159,159,173016,1,1107,"0:21","org.knime.base.node.mine.treeensemble2.node.learner.classification.TreeEnsembleClassificationLearnerNodeModel"
"Random Forest Learner",155,155,173171,1,1108,"0:21","org.knime.base.node.mine.treeensemble2.node.learner.classification.TreeEnsembleClassificationLearnerNodeModel"
"Random Forest Learner",169,169,173340,1,1109,"0:21","org.knime.base.node.mine.treeensemble2.node.learner.classification.TreeEnsembleClassificationLearnerNodeModel"
"Random Forest Learner",161,161,173501,1,1110,"0:21","org.knime.base.node.mine.treeensemble2.node.learner.classification.TreeEnsembleClassificationLearnerNodeModel"
"Random Forest Learner",193,193,173694,1,1111,"0:21","org.knime.base.node.mine.treeensemble2.node.learner.classification.TreeEnsembleClassificationLearnerNodeModel"
"Random Forest Learner",153,153,173847,1,1112,"0:21","org.knime.base.node.mine.treeensemble2.node.learner.classification.TreeEnsembleClassificationLearnerNodeModel"
"Random Forest Learner",146,146,173993,1,1113,"0:21","org.knime.base.node.mine.treeensemble2.node.learner.classification.TreeEnsembleClassificationLearnerNodeModel"
"Random Forest Learner",166,166,174159,1,1114,"0:21","org.knime.base.node.mine.treeensemble2.node.learner.classification.TreeEnsembleClassificationLearnerNodeModel"
"Random Forest Learner",148,148,174307,1,1115,"0:21","org.knime.base.node.mine.treeensemble2.node.learner.classification.TreeEnsembleClassificationLearnerNodeModel"
"Random Forest Learner",148,148,174455,1,1116,"0:21","org.knime.base.node.mine.treeensemble2.node.learner.classification.TreeEnsembleClassificationLearnerNodeModel"
"Random Forest Learner",178,178,174633,1,1117,"0:21","org.knime.base.node.mine.treeensemble2.node.learner.classification.TreeEnsembleClassificationLearnerNodeModel"
"Random Forest Learner",158,158,174791,1,1118,"0:21","org.knime.base.node.mine.treeensemble2.node.learner.classification.TreeEnsembleClassificationLearnerNodeModel"
"Random Forest Learner",159,159,174950,1,1119,"0:21","org.knime.base.node.mine.treeensemble2.node.learner.classification.TreeEnsembleClassificationLearnerNodeModel"
"Random Forest Learner",161,161,175111,1,1120,"0:21","org.knime.base.node.mine.treeensemble2.node.learner.classification.TreeEnsembleClassificationLearnerNodeModel"
"Random Forest Learner",134,134,175245,1,1121,"0:21","org.knime.base.node.mine.treeensemble2.node.learner.classification.TreeEnsembleClassificationLearnerNodeModel"
"Random Forest Learner",158,158,175403,1,1122,"0:21","org.knime.base.node.mine.treeensemble2.node.learner.classification.TreeEnsembleClassificationLearnerNodeModel"
"Random Forest Learner",187,187,175590,1,1123,"0:21","org.knime.base.node.mine.treeensemble2.node.learner.classification.TreeEnsembleClassificationLearnerNodeModel"
"Random Forest Learner",153,153,175743,1,1124,"0:21","org.knime.base.node.mine.treeensemble2.node.learner.classification.TreeEnsembleClassificationLearnerNodeModel"
"Random Forest Learner",164,164,175907,1,1125,"0:21","org.knime.base.node.mine.treeensemble2.node.learner.classification.TreeEnsembleClassificationLearnerNodeModel"
"Random Forest Learner",135,135,176042,1,1126,"0:21","org.knime.base.node.mine.treeensemble2.node.learner.classification.TreeEnsembleClassificationLearnerNodeModel"
"Random Forest Learner",142,142,176184,1,1127,"0:21","org.knime.base.node.mine.treeensemble2.node.learner.classification.TreeEnsembleClassificationLearnerNodeModel"
"Random Forest Learner",147,147,176331,1,1128,"0:21","org.knime.base.node.mine.treeensemble2.node.learner.classification.TreeEnsembleClassificationLearnerNodeModel"
"Random Forest Learner",136,136,176467,1,1129,"0:21","org.knime.base.node.mine.treeensemble2.node.learner.classification.TreeEnsembleClassificationLearnerNodeModel"
"Random Forest Learner",138,138,176605,1,1130,"0:21","org.knime.base.node.mine.treeensemble2.node.learner.classification.TreeEnsembleClassificationLearnerNodeModel"
"Random Forest Learner",143,143,176748,1,1131,"0:21","org.knime.base.node.mine.treeensemble2.node.learner.classification.TreeEnsembleClassificationLearnerNodeModel"
"Random Forest Learner",142,142,176890,1,1132,"0:21","org.knime.base.node.mine.treeensemble2.node.learner.classification.TreeEnsembleClassificationLearnerNodeModel"
"Random Forest Learner",135,135,177025,1,1133,"0:21","org.knime.base.node.mine.treeensemble2.node.learner.classification.TreeEnsembleClassificationLearnerNodeModel"
"Random Forest Learner",133,133,177158,1,1134,"0:21","org.knime.base.node.mine.treeensemble2.node.learner.classification.TreeEnsembleClassificationLearnerNodeModel"
"Random Forest Learner",129,129,177287,1,1135,"0:21","org.knime.base.node.mine.treeensemble2.node.learner.classification.TreeEnsembleClassificationLearnerNodeModel"
"Random Forest Learner",141,141,177428,1,1136,"0:21","org.knime.base.node.mine.treeensemble2.node.learner.classification.TreeEnsembleClassificationLearnerNodeModel"
"Random Forest Learner",134,134,177562,1,1137,"0:21","org.knime.base.node.mine.treeensemble2.node.learner.classification.TreeEnsembleClassificationLearnerNodeModel"
"Random Forest Learner",132,132,177694,1,1138,"0:21","org.knime.base.node.mine.treeensemble2.node.learner.classification.TreeEnsembleClassificationLearnerNodeModel"
"Random Forest Learner",141,141,177835,1,1139,"0:21","org.knime.base.node.mine.treeensemble2.node.learner.classification.TreeEnsembleClassificationLearnerNodeModel"
"Random Forest Learner",175,175,178010,1,1140,"0:21","org.knime.base.node.mine.treeensemble2.node.learner.classification.TreeEnsembleClassificationLearnerNodeModel"
"Random Forest Learner",132,132,178142,1,1141,"0:21","org.knime.base.node.mine.treeensemble2.node.learner.classification.TreeEnsembleClassificationLearnerNodeModel"
"Random Forest Learner",138,138,178280,1,1142,"0:21","org.knime.base.node.mine.treeensemble2.node.learner.classification.TreeEnsembleClassificationLearnerNodeModel"
"Random Forest Learner",161,161,178441,1,1143,"0:21","org.knime.base.node.mine.treeensemble2.node.learner.classification.TreeEnsembleClassificationLearnerNodeModel"
"Random Forest Learner",133,133,178574,1,1144,"0:21","org.knime.base.node.mine.treeensemble2.node.learner.classification.TreeEnsembleClassificationLearnerNodeModel"
"Random Forest Learner",147,147,178721,1,1145,"0:21","org.knime.base.node.mine.treeensemble2.node.learner.classification.TreeEnsembleClassificationLearnerNodeModel"
"Random Forest Learner",160,160,178881,1,1146,"0:21","org.knime.base.node.mine.treeensemble2.node.learner.classification.TreeEnsembleClassificationLearnerNodeModel"
"Random Forest Learner",134,134,179015,1,1147,"0:21","org.knime.base.node.mine.treeensemble2.node.learner.classification.TreeEnsembleClassificationLearnerNodeModel"
"Random Forest Learner",135,135,179150,1,1148,"0:21","org.knime.base.node.mine.treeensemble2.node.learner.classification.TreeEnsembleClassificationLearnerNodeModel"
"Random Forest Learner",160,160,179310,1,1149,"0:21","org.knime.base.node.mine.treeensemble2.node.learner.classification.TreeEnsembleClassificationLearnerNodeModel"
"Random Forest Learner",127,127,179437,1,1150,"0:21","org.knime.base.node.mine.treeensemble2.node.learner.classification.TreeEnsembleClassificationLearnerNodeModel"
"Random Forest Learner",137,137,179574,1,1151,"0:21","org.knime.base.node.mine.treeensemble2.node.learner.classification.TreeEnsembleClassificationLearnerNodeModel"
"Random Forest Learner",161,161,179735,1,1152,"0:21","org.knime.base.node.mine.treeensemble2.node.learner.classification.TreeEnsembleClassificationLearnerNodeModel"
"Random Forest Learner",141,141,179876,1,1153,"0:21","org.knime.base.node.mine.treeensemble2.node.learner.classification.TreeEnsembleClassificationLearnerNodeModel"
"Random Forest Learner",131,131,180007,1,1154,"0:21","org.knime.base.node.mine.treeensemble2.node.learner.classification.TreeEnsembleClassificationLearnerNodeModel"
"Random Forest Learner",163,163,180170,1,1155,"0:21","org.knime.base.node.mine.treeensemble2.node.learner.classification.TreeEnsembleClassificationLearnerNodeModel"
"Random Forest Learner",139,139,180309,1,1156,"0:21","org.knime.base.node.mine.treeensemble2.node.learner.classification.TreeEnsembleClassificationLearnerNodeModel"
"Random Forest Learner",135,135,180444,1,1157,"0:21","org.knime.base.node.mine.treeensemble2.node.learner.classification.TreeEnsembleClassificationLearnerNodeModel"
"Random Forest Learner",140,140,180584,1,1158,"0:21","org.knime.base.node.mine.treeensemble2.node.learner.classification.TreeEnsembleClassificationLearnerNodeModel"
"Random Forest Learner",136,136,180720,1,1159,"0:21","org.knime.base.node.mine.treeensemble2.node.learner.classification.TreeEnsembleClassificationLearnerNodeModel"
"Random Forest Learner",141,141,180861,1,1160,"0:21","org.knime.base.node.mine.treeensemble2.node.learner.classification.TreeEnsembleClassificationLearnerNodeModel"
"Random Forest Learner",136,136,180997,1,1161,"0:21","org.knime.base.node.mine.treeensemble2.node.learner.classification.TreeEnsembleClassificationLearnerNodeModel"
"Random Forest Learner",131,131,181128,1,1162,"0:21","org.knime.base.node.mine.treeensemble2.node.learner.classification.TreeEnsembleClassificationLearnerNodeModel"
"Random Forest Learner",147,147,181275,1,1163,"0:21","org.knime.base.node.mine.treeensemble2.node.learner.classification.TreeEnsembleClassificationLearnerNodeModel"
"Random Forest Learner",137,137,181412,1,1164,"0:21","org.knime.base.node.mine.treeensemble2.node.learner.classification.TreeEnsembleClassificationLearnerNodeModel"
"Random Forest Learner",135,135,181547,1,1165,"0:21","org.knime.base.node.mine.treeensemble2.node.learner.classification.TreeEnsembleClassificationLearnerNodeModel"
"Random Forest Learner",156,156,181703,1,1166,"0:21","org.knime.base.node.mine.treeensemble2.node.learner.classification.TreeEnsembleClassificationLearnerNodeModel"
"Random Forest Learner",136,136,181839,1,1167,"0:21","org.knime.base.node.mine.treeensemble2.node.learner.classification.TreeEnsembleClassificationLearnerNodeModel"
"Random Forest Learner",138,138,181977,1,1168,"0:21","org.knime.base.node.mine.treeensemble2.node.learner.classification.TreeEnsembleClassificationLearnerNodeModel"
"Random Forest Learner",174,174,182151,1,1169,"0:21","org.knime.base.node.mine.treeensemble2.node.learner.classification.TreeEnsembleClassificationLearnerNodeModel"
"Random Forest Learner",136,136,182287,1,1170,"0:21","org.knime.base.node.mine.treeensemble2.node.learner.classification.TreeEnsembleClassificationLearnerNodeModel"
"Random Forest Learner",145,145,182432,1,1171,"0:21","org.knime.base.node.mine.treeensemble2.node.learner.classification.TreeEnsembleClassificationLearnerNodeModel"
"Random Forest Learner",153,153,182585,1,1172,"0:21","org.knime.base.node.mine.treeensemble2.node.learner.classification.TreeEnsembleClassificationLearnerNodeModel"
"Random Forest Learner",146,146,182731,1,1173,"0:21","org.knime.base.node.mine.treeensemble2.node.learner.classification.TreeEnsembleClassificationLearnerNodeModel"
"Random Forest Learner",138,138,182869,1,1174,"0:21","org.knime.base.node.mine.treeensemble2.node.learner.classification.TreeEnsembleClassificationLearnerNodeModel"
"Random Forest Learner",168,168,183037,1,1175,"0:21","org.knime.base.node.mine.treeensemble2.node.learner.classification.TreeEnsembleClassificationLearnerNodeModel"
"Random Forest Learner",152,152,183189,1,1176,"0:21","org.knime.base.node.mine.treeensemble2.node.learner.classification.TreeEnsembleClassificationLearnerNodeModel"
"Random Forest Learner",146,146,183335,1,1177,"0:21","org.knime.base.node.mine.treeensemble2.node.learner.classification.TreeEnsembleClassificationLearnerNodeModel"
"Random Forest Learner",139,139,183474,1,1178,"0:21","org.knime.base.node.mine.treeensemble2.node.learner.classification.TreeEnsembleClassificationLearnerNodeModel"
"Random Forest Learner",147,147,183621,1,1179,"0:21","org.knime.base.node.mine.treeensemble2.node.learner.classification.TreeEnsembleClassificationLearnerNodeModel"
"Random Forest Learner",135,135,183756,1,1180,"0:21","org.knime.base.node.mine.treeensemble2.node.learner.classification.TreeEnsembleClassificationLearnerNodeModel"
"Random Forest Learner",153,153,183909,1,1181,"0:21","org.knime.base.node.mine.treeensemble2.node.learner.classification.TreeEnsembleClassificationLearnerNodeModel"
"Random Forest Learner",135,135,184044,1,1182,"0:21","org.knime.base.node.mine.treeensemble2.node.learner.classification.TreeEnsembleClassificationLearnerNodeModel"
"Random Forest Learner",172,172,184216,1,1183,"0:21","org.knime.base.node.mine.treeensemble2.node.learner.classification.TreeEnsembleClassificationLearnerNodeModel"
"Random Forest Learner",140,140,184356,1,1184,"0:21","org.knime.base.node.mine.treeensemble2.node.learner.classification.TreeEnsembleClassificationLearnerNodeModel"
"Random Forest Learner",133,133,184489,1,1185,"0:21","org.knime.base.node.mine.treeensemble2.node.learner.classification.TreeEnsembleClassificationLearnerNodeModel"
"Random Forest Learner",162,162,184651,1,1186,"0:21","org.knime.base.node.mine.treeensemble2.node.learner.classification.TreeEnsembleClassificationLearnerNodeModel"
"Random Forest Learner",145,145,184796,1,1187,"0:21","org.knime.base.node.mine.treeensemble2.node.learner.classification.TreeEnsembleClassificationLearnerNodeModel"
"Random Forest Learner",152,152,184948,1,1188,"0:21","org.knime.base.node.mine.treeensemble2.node.learner.classification.TreeEnsembleClassificationLearnerNodeModel"
"Random Forest Learner",140,140,185088,1,1189,"0:21","org.knime.base.node.mine.treeensemble2.node.learner.classification.TreeEnsembleClassificationLearnerNodeModel"
"Random Forest Learner",153,153,185241,1,1190,"0:21","org.knime.base.node.mine.treeensemble2.node.learner.classification.TreeEnsembleClassificationLearnerNodeModel"
"Random Forest Learner",165,165,185406,1,1191,"0:21","org.knime.base.node.mine.treeensemble2.node.learner.classification.TreeEnsembleClassificationLearnerNodeModel"
"Random Forest Learner",146,146,185552,1,1192,"0:21","org.knime.base.node.mine.treeensemble2.node.learner.classification.TreeEnsembleClassificationLearnerNodeModel"
"Random Forest Learner",136,136,185688,1,1193,"0:21","org.knime.base.node.mine.treeensemble2.node.learner.classification.TreeEnsembleClassificationLearnerNodeModel"
"Random Forest Learner",160,160,185848,1,1194,"0:21","org.knime.base.node.mine.treeensemble2.node.learner.classification.TreeEnsembleClassificationLearnerNodeModel"
"Random Forest Learner",149,149,185997,1,1195,"0:21","org.knime.base.node.mine.treeensemble2.node.learner.classification.TreeEnsembleClassificationLearnerNodeModel"
"Random Forest Learner",142,142,186139,1,1196,"0:21","org.knime.base.node.mine.treeensemble2.node.learner.classification.TreeEnsembleClassificationLearnerNodeModel"
"Random Forest Learner",169,169,186308,1,1197,"0:21","org.knime.base.node.mine.treeensemble2.node.learner.classification.TreeEnsembleClassificationLearnerNodeModel"
"Random Forest Learner",133,133,186441,1,1198,"0:21","org.knime.base.node.mine.treeensemble2.node.learner.classification.TreeEnsembleClassificationLearnerNodeModel"
"Random Forest Learner",138,138,186579,1,1199,"0:21","org.knime.base.node.mine.treeensemble2.node.learner.classification.TreeEnsembleClassificationLearnerNodeModel"
"Random Forest Learner",157,157,186736,1,1200,"0:21","org.knime.base.node.mine.treeensemble2.node.learner.classification.TreeEnsembleClassificationLearnerNodeModel"
"Random Forest Learner",136,136,186872,1,1201,"0:21","org.knime.base.node.mine.treeensemble2.node.learner.classification.TreeEnsembleClassificationLearnerNodeModel"
"Random Forest Learner",163,163,187035,1,1202,"0:21","org.knime.base.node.mine.treeensemble2.node.learner.classification.TreeEnsembleClassificationLearnerNodeModel"
"Random Forest Learner",141,141,187176,1,1203,"0:21","org.knime.base.node.mine.treeensemble2.node.learner.classification.TreeEnsembleClassificationLearnerNodeModel"
"Random Forest Learner",152,152,187328,1,1204,"0:21","org.knime.base.node.mine.treeensemble2.node.learner.classification.TreeEnsembleClassificationLearnerNodeModel"
"Random Forest Learner",156,156,187484,1,1205,"0:21","org.knime.base.node.mine.treeensemble2.node.learner.classification.TreeEnsembleClassificationLearnerNodeModel"
"Random Forest Learner",143,143,187627,1,1206,"0:21","org.knime.base.node.mine.treeensemble2.node.learner.classification.TreeEnsembleClassificationLearnerNodeModel"
"Random Forest Learner",153,153,187780,1,1207,"0:21","org.knime.base.node.mine.treeensemble2.node.learner.classification.TreeEnsembleClassificationLearnerNodeModel"
"Random Forest Learner",140,140,187920,1,1208,"0:21","org.knime.base.node.mine.treeensemble2.node.learner.classification.TreeEnsembleClassificationLearnerNodeModel"
"Random Forest Learner",148,148,188068,1,1209,"0:21","org.knime.base.node.mine.treeensemble2.node.learner.classification.TreeEnsembleClassificationLearnerNodeModel"
"Random Forest Learner",165,165,188233,1,1210,"0:21","org.knime.base.node.mine.treeensemble2.node.learner.classification.TreeEnsembleClassificationLearnerNodeModel"
"Random Forest Learner",153,153,188386,1,1211,"0:21","org.knime.base.node.mine.treeensemble2.node.learner.classification.TreeEnsembleClassificationLearnerNodeModel"
"Random Forest Learner",146,146,188532,1,1212,"0:21","org.knime.base.node.mine.treeensemble2.node.learner.classification.TreeEnsembleClassificationLearnerNodeModel"
"Random Forest Learner",158,158,188690,1,1213,"0:21","org.knime.base.node.mine.treeensemble2.node.learner.classification.TreeEnsembleClassificationLearnerNodeModel"
"Random Forest Learner",156,156,188846,1,1214,"0:21","org.knime.base.node.mine.treeensemble2.node.learner.classification.TreeEnsembleClassificationLearnerNodeModel"
"Random Forest Learner",138,138,188984,1,1215,"0:21","org.knime.base.node.mine.treeensemble2.node.learner.classification.TreeEnsembleClassificationLearnerNodeModel"
"Random Forest Learner",143,143,189127,1,1216,"0:21","org.knime.base.node.mine.treeensemble2.node.learner.classification.TreeEnsembleClassificationLearnerNodeModel"
"Random Forest Learner",145,145,189272,1,1217,"0:21","org.knime.base.node.mine.treeensemble2.node.learner.classification.TreeEnsembleClassificationLearnerNodeModel"
"Random Forest Learner",183,183,189455,1,1218,"0:21","org.knime.base.node.mine.treeensemble2.node.learner.classification.TreeEnsembleClassificationLearnerNodeModel"
"Random Forest Learner",148,148,189603,1,1219,"0:21","org.knime.base.node.mine.treeensemble2.node.learner.classification.TreeEnsembleClassificationLearnerNodeModel"
"Random Forest Learner",144,144,189747,1,1220,"0:21","org.knime.base.node.mine.treeensemble2.node.learner.classification.TreeEnsembleClassificationLearnerNodeModel"
"Random Forest Learner",162,162,189909,1,1221,"0:21","org.knime.base.node.mine.treeensemble2.node.learner.classification.TreeEnsembleClassificationLearnerNodeModel"
"Random Forest Learner",155,155,190064,1,1222,"0:21","org.knime.base.node.mine.treeensemble2.node.learner.classification.TreeEnsembleClassificationLearnerNodeModel"
"Random Forest Learner",154,154,190218,1,1223,"0:21","org.knime.base.node.mine.treeensemble2.node.learner.classification.TreeEnsembleClassificationLearnerNodeModel"
"Random Forest Learner",158,158,190376,1,1224,"0:21","org.knime.base.node.mine.treeensemble2.node.learner.classification.TreeEnsembleClassificationLearnerNodeModel"
"Random Forest Learner",147,147,190523,1,1225,"0:21","org.knime.base.node.mine.treeensemble2.node.learner.classification.TreeEnsembleClassificationLearnerNodeModel"
"Random Forest Learner",174,174,190697,1,1226,"0:21","org.knime.base.node.mine.treeensemble2.node.learner.classification.TreeEnsembleClassificationLearnerNodeModel"
"Random Forest Learner",155,155,190852,1,1227,"0:21","org.knime.base.node.mine.treeensemble2.node.learner.classification.TreeEnsembleClassificationLearnerNodeModel"
"Random Forest Learner",154,154,191006,1,1228,"0:21","org.knime.base.node.mine.treeensemble2.node.learner.classification.TreeEnsembleClassificationLearnerNodeModel"
"Random Forest Learner",192,192,191198,1,1229,"0:21","org.knime.base.node.mine.treeensemble2.node.learner.classification.TreeEnsembleClassificationLearnerNodeModel"
"Random Forest Learner",150,150,191348,1,1230,"0:21","org.knime.base.node.mine.treeensemble2.node.learner.classification.TreeEnsembleClassificationLearnerNodeModel"
"Random Forest Learner",181,181,191529,1,1231,"0:21","org.knime.base.node.mine.treeensemble2.node.learner.classification.TreeEnsembleClassificationLearnerNodeModel"
"Random Forest Learner",158,158,191687,1,1232,"0:21","org.knime.base.node.mine.treeensemble2.node.learner.classification.TreeEnsembleClassificationLearnerNodeModel"
"Random Forest Learner",146,146,191833,1,1233,"0:21","org.knime.base.node.mine.treeensemble2.node.learner.classification.TreeEnsembleClassificationLearnerNodeModel"
"Random Forest Learner",179,179,192012,1,1234,"0:21","org.knime.base.node.mine.treeensemble2.node.learner.classification.TreeEnsembleClassificationLearnerNodeModel"
"Random Forest Learner",156,156,192168,1,1235,"0:21","org.knime.base.node.mine.treeensemble2.node.learner.classification.TreeEnsembleClassificationLearnerNodeModel"
"Random Forest Learner",179,179,192347,1,1236,"0:21","org.knime.base.node.mine.treeensemble2.node.learner.classification.TreeEnsembleClassificationLearnerNodeModel"
"Random Forest Learner",155,155,192502,1,1237,"0:21","org.knime.base.node.mine.treeensemble2.node.learner.classification.TreeEnsembleClassificationLearnerNodeModel"
"Random Forest Learner",144,144,192646,1,1238,"0:21","org.knime.base.node.mine.treeensemble2.node.learner.classification.TreeEnsembleClassificationLearnerNodeModel"
"Random Forest Learner",176,176,192822,1,1239,"0:21","org.knime.base.node.mine.treeensemble2.node.learner.classification.TreeEnsembleClassificationLearnerNodeModel"
"Random Forest Learner",154,154,192976,1,1240,"0:21","org.knime.base.node.mine.treeensemble2.node.learner.classification.TreeEnsembleClassificationLearnerNodeModel"
"Random Forest Learner",147,147,193123,1,1241,"0:21","org.knime.base.node.mine.treeensemble2.node.learner.classification.TreeEnsembleClassificationLearnerNodeModel"
"Random Forest Learner",219,219,193342,1,1242,"0:21","org.knime.base.node.mine.treeensemble2.node.learner.classification.TreeEnsembleClassificationLearnerNodeModel"
"Random Forest Learner",154,154,193496,1,1243,"0:21","org.knime.base.node.mine.treeensemble2.node.learner.classification.TreeEnsembleClassificationLearnerNodeModel"
"Random Forest Learner",170,170,193666,1,1244,"0:21","org.knime.base.node.mine.treeensemble2.node.learner.classification.TreeEnsembleClassificationLearnerNodeModel"
"Random Forest Learner",149,149,193815,1,1245,"0:21","org.knime.base.node.mine.treeensemble2.node.learner.classification.TreeEnsembleClassificationLearnerNodeModel"
"Random Forest Learner",155,155,193970,1,1246,"0:21","org.knime.base.node.mine.treeensemble2.node.learner.classification.TreeEnsembleClassificationLearnerNodeModel"
"Random Forest Learner",165,165,194135,1,1247,"0:21","org.knime.base.node.mine.treeensemble2.node.learner.classification.TreeEnsembleClassificationLearnerNodeModel"
"Random Forest Learner",154,154,194289,1,1248,"0:21","org.knime.base.node.mine.treeensemble2.node.learner.classification.TreeEnsembleClassificationLearnerNodeModel"
"Random Forest Learner",166,166,194455,1,1249,"0:21","org.knime.base.node.mine.treeensemble2.node.learner.classification.TreeEnsembleClassificationLearnerNodeModel"
"Random Forest Learner",149,149,194604,1,1250,"0:21","org.knime.base.node.mine.treeensemble2.node.learner.classification.TreeEnsembleClassificationLearnerNodeModel"
"Random Forest Learner",164,164,194768,1,1251,"0:21","org.knime.base.node.mine.treeensemble2.node.learner.classification.TreeEnsembleClassificationLearnerNodeModel"
"Random Forest Learner",170,170,194938,1,1252,"0:21","org.knime.base.node.mine.treeensemble2.node.learner.classification.TreeEnsembleClassificationLearnerNodeModel"
"Random Forest Learner",165,165,195103,1,1253,"0:21","org.knime.base.node.mine.treeensemble2.node.learner.classification.TreeEnsembleClassificationLearnerNodeModel"
"Random Forest Learner",197,197,195300,1,1254,"0:21","org.knime.base.node.mine.treeensemble2.node.learner.classification.TreeEnsembleClassificationLearnerNodeModel"
"Random Forest Learner",157,157,195457,1,1255,"0:21","org.knime.base.node.mine.treeensemble2.node.learner.classification.TreeEnsembleClassificationLearnerNodeModel"
"Random Forest Learner",189,189,195646,1,1256,"0:21","org.knime.base.node.mine.treeensemble2.node.learner.classification.TreeEnsembleClassificationLearnerNodeModel"
"Random Forest Learner",163,163,195809,1,1257,"0:21","org.knime.base.node.mine.treeensemble2.node.learner.classification.TreeEnsembleClassificationLearnerNodeModel"
"Random Forest Learner",148,148,195957,1,1258,"0:21","org.knime.base.node.mine.treeensemble2.node.learner.classification.TreeEnsembleClassificationLearnerNodeModel"
"Random Forest Learner",176,176,196133,1,1259,"0:21","org.knime.base.node.mine.treeensemble2.node.learner.classification.TreeEnsembleClassificationLearnerNodeModel"
"Random Forest Learner",173,173,196306,1,1260,"0:21","org.knime.base.node.mine.treeensemble2.node.learner.classification.TreeEnsembleClassificationLearnerNodeModel"
"Random Forest Learner",185,185,196491,1,1261,"0:21","org.knime.base.node.mine.treeensemble2.node.learner.classification.TreeEnsembleClassificationLearnerNodeModel"
"Random Forest Learner",172,172,196663,1,1262,"0:21","org.knime.base.node.mine.treeensemble2.node.learner.classification.TreeEnsembleClassificationLearnerNodeModel"
"Random Forest Learner",173,173,196836,1,1263,"0:21","org.knime.base.node.mine.treeensemble2.node.learner.classification.TreeEnsembleClassificationLearnerNodeModel"
"Random Forest Learner",172,172,197008,1,1264,"0:21","org.knime.base.node.mine.treeensemble2.node.learner.classification.TreeEnsembleClassificationLearnerNodeModel"
"Random Forest Learner",157,157,197165,1,1265,"0:21","org.knime.base.node.mine.treeensemble2.node.learner.classification.TreeEnsembleClassificationLearnerNodeModel"
"Random Forest Learner",186,186,197351,1,1266,"0:21","org.knime.base.node.mine.treeensemble2.node.learner.classification.TreeEnsembleClassificationLearnerNodeModel"
"Random Forest Learner",170,170,197521,1,1267,"0:21","org.knime.base.node.mine.treeensemble2.node.learner.classification.TreeEnsembleClassificationLearnerNodeModel"
"Random Forest Learner",184,184,197705,1,1268,"0:21","org.knime.base.node.mine.treeensemble2.node.learner.classification.TreeEnsembleClassificationLearnerNodeModel"
"Random Forest Learner",174,174,197879,1,1269,"0:21","org.knime.base.node.mine.treeensemble2.node.learner.classification.TreeEnsembleClassificationLearnerNodeModel"
"Random Forest Learner",170,170,198049,1,1270,"0:21","org.knime.base.node.mine.treeensemble2.node.learner.classification.TreeEnsembleClassificationLearnerNodeModel"
"Random Forest Learner",166,166,198215,1,1271,"0:21","org.knime.base.node.mine.treeensemble2.node.learner.classification.TreeEnsembleClassificationLearnerNodeModel"
"Random Forest Learner",160,160,198375,1,1272,"0:21","org.knime.base.node.mine.treeensemble2.node.learner.classification.TreeEnsembleClassificationLearnerNodeModel"
"Random Forest Learner",185,185,198560,1,1273,"0:21","org.knime.base.node.mine.treeensemble2.node.learner.classification.TreeEnsembleClassificationLearnerNodeModel"
"Random Forest Learner",173,173,198733,1,1274,"0:21","org.knime.base.node.mine.treeensemble2.node.learner.classification.TreeEnsembleClassificationLearnerNodeModel"
"Random Forest Learner",193,193,198926,1,1275,"0:21","org.knime.base.node.mine.treeensemble2.node.learner.classification.TreeEnsembleClassificationLearnerNodeModel"
"Random Forest Learner",173,173,199099,1,1276,"0:21","org.knime.base.node.mine.treeensemble2.node.learner.classification.TreeEnsembleClassificationLearnerNodeModel"
"Random Forest Learner",157,157,199256,1,1277,"0:21","org.knime.base.node.mine.treeensemble2.node.learner.classification.TreeEnsembleClassificationLearnerNodeModel"
"Random Forest Learner",161,161,199417,1,1278,"0:21","org.knime.base.node.mine.treeensemble2.node.learner.classification.TreeEnsembleClassificationLearnerNodeModel"
"Random Forest Learner",160,160,199577,1,1279,"0:21","org.knime.base.node.mine.treeensemble2.node.learner.classification.TreeEnsembleClassificationLearnerNodeModel"
"Random Forest Learner",184,184,199761,1,1280,"0:21","org.knime.base.node.mine.treeensemble2.node.learner.classification.TreeEnsembleClassificationLearnerNodeModel"
"Random Forest Learner",169,169,199930,1,1281,"0:21","org.knime.base.node.mine.treeensemble2.node.learner.classification.TreeEnsembleClassificationLearnerNodeModel"
"Random Forest Learner",185,185,200115,1,1282,"0:21","org.knime.base.node.mine.treeensemble2.node.learner.classification.TreeEnsembleClassificationLearnerNodeModel"
"Random Forest Learner",169,169,200284,1,1283,"0:21","org.knime.base.node.mine.treeensemble2.node.learner.classification.TreeEnsembleClassificationLearnerNodeModel"
"Random Forest Learner",150,150,200434,1,1284,"0:21","org.knime.base.node.mine.treeensemble2.node.learner.classification.TreeEnsembleClassificationLearnerNodeModel"
"Random Forest Learner",181,181,200615,1,1285,"0:21","org.knime.base.node.mine.treeensemble2.node.learner.classification.TreeEnsembleClassificationLearnerNodeModel"
"Random Forest Learner",166,166,200781,1,1286,"0:21","org.knime.base.node.mine.treeensemble2.node.learner.classification.TreeEnsembleClassificationLearnerNodeModel"
"Random Forest Learner",186,186,200967,1,1287,"0:21","org.knime.base.node.mine.treeensemble2.node.learner.classification.TreeEnsembleClassificationLearnerNodeModel"
"Random Forest Learner",166,166,201133,1,1288,"0:21","org.knime.base.node.mine.treeensemble2.node.learner.classification.TreeEnsembleClassificationLearnerNodeModel"
"Random Forest Learner",193,193,201326,1,1289,"0:21","org.knime.base.node.mine.treeensemble2.node.learner.classification.TreeEnsembleClassificationLearnerNodeModel"
"Random Forest Learner",176,176,201502,1,1290,"0:21","org.knime.base.node.mine.treeensemble2.node.learner.classification.TreeEnsembleClassificationLearnerNodeModel"
"Random Forest Learner",170,170,201672,1,1291,"0:21","org.knime.base.node.mine.treeensemble2.node.learner.classification.TreeEnsembleClassificationLearnerNodeModel"
"Random Forest Learner",160,160,201832,1,1292,"0:21","org.knime.base.node.mine.treeensemble2.node.learner.classification.TreeEnsembleClassificationLearnerNodeModel"
"Random Forest Learner",159,159,201991,1,1293,"0:21","org.knime.base.node.mine.treeensemble2.node.learner.classification.TreeEnsembleClassificationLearnerNodeModel"
"Random Forest Learner",175,175,202166,1,1294,"0:21","org.knime.base.node.mine.treeensemble2.node.learner.classification.TreeEnsembleClassificationLearnerNodeModel"
"Random Forest Learner",172,172,202338,1,1295,"0:21","org.knime.base.node.mine.treeensemble2.node.learner.classification.TreeEnsembleClassificationLearnerNodeModel"
"Random Forest Learner",191,191,202529,1,1296,"0:21","org.knime.base.node.mine.treeensemble2.node.learner.classification.TreeEnsembleClassificationLearnerNodeModel"
"Random Forest Learner",172,172,202701,1,1297,"0:21","org.knime.base.node.mine.treeensemble2.node.learner.classification.TreeEnsembleClassificationLearnerNodeModel"
"Random Forest Learner",166,166,202867,1,1298,"0:21","org.knime.base.node.mine.treeensemble2.node.learner.classification.TreeEnsembleClassificationLearnerNodeModel"
"Random Forest Learner",160,160,203027,1,1299,"0:21","org.knime.base.node.mine.treeensemble2.node.learner.classification.TreeEnsembleClassificationLearnerNodeModel"
"Random Forest Learner",177,177,203204,1,1300,"0:21","org.knime.base.node.mine.treeensemble2.node.learner.classification.TreeEnsembleClassificationLearnerNodeModel"
"Random Forest Learner",184,184,203388,1,1301,"0:21","org.knime.base.node.mine.treeensemble2.node.learner.classification.TreeEnsembleClassificationLearnerNodeModel"
"Random Forest Learner",175,175,203563,1,1302,"0:21","org.knime.base.node.mine.treeensemble2.node.learner.classification.TreeEnsembleClassificationLearnerNodeModel"
"Random Forest Learner",181,181,203744,1,1303,"0:21","org.knime.base.node.mine.treeensemble2.node.learner.classification.TreeEnsembleClassificationLearnerNodeModel"
"Random Forest Learner",176,176,203920,1,1304,"0:21","org.knime.base.node.mine.treeensemble2.node.learner.classification.TreeEnsembleClassificationLearnerNodeModel"
"Random Forest Learner",189,189,204109,1,1305,"0:21","org.knime.base.node.mine.treeensemble2.node.learner.classification.TreeEnsembleClassificationLearnerNodeModel"
"Random Forest Learner",183,183,204292,1,1306,"0:21","org.knime.base.node.mine.treeensemble2.node.learner.classification.TreeEnsembleClassificationLearnerNodeModel"
"Random Forest Learner",168,168,204460,1,1307,"0:21","org.knime.base.node.mine.treeensemble2.node.learner.classification.TreeEnsembleClassificationLearnerNodeModel"
"Random Forest Learner",162,162,204622,1,1308,"0:21","org.knime.base.node.mine.treeensemble2.node.learner.classification.TreeEnsembleClassificationLearnerNodeModel"
"Random Forest Learner",167,167,204789,1,1309,"0:21","org.knime.base.node.mine.treeensemble2.node.learner.classification.TreeEnsembleClassificationLearnerNodeModel"
"Random Forest Learner",193,193,204982,1,1310,"0:21","org.knime.base.node.mine.treeensemble2.node.learner.classification.TreeEnsembleClassificationLearnerNodeModel"
"Random Forest Learner",170,170,205152,1,1311,"0:21","org.knime.base.node.mine.treeensemble2.node.learner.classification.TreeEnsembleClassificationLearnerNodeModel"
"Random Forest Learner",180,180,205332,1,1312,"0:21","org.knime.base.node.mine.treeensemble2.node.learner.classification.TreeEnsembleClassificationLearnerNodeModel"
"Random Forest Learner",180,180,205512,1,1313,"0:21","org.knime.base.node.mine.treeensemble2.node.learner.classification.TreeEnsembleClassificationLearnerNodeModel"
"Random Forest Learner",186,186,205698,1,1314,"0:21","org.knime.base.node.mine.treeensemble2.node.learner.classification.TreeEnsembleClassificationLearnerNodeModel"
"Random Forest Learner",178,178,205876,1,1315,"0:21","org.knime.base.node.mine.treeensemble2.node.learner.classification.TreeEnsembleClassificationLearnerNodeModel"
"Random Forest Learner",165,165,206041,1,1316,"0:21","org.knime.base.node.mine.treeensemble2.node.learner.classification.TreeEnsembleClassificationLearnerNodeModel"
"Random Forest Learner",169,169,206210,1,1317,"0:21","org.knime.base.node.mine.treeensemble2.node.learner.classification.TreeEnsembleClassificationLearnerNodeModel"
"Random Forest Learner",174,174,206384,1,1318,"0:21","org.knime.base.node.mine.treeensemble2.node.learner.classification.TreeEnsembleClassificationLearnerNodeModel"
"Random Forest Learner",192,192,206576,1,1319,"0:21","org.knime.base.node.mine.treeensemble2.node.learner.classification.TreeEnsembleClassificationLearnerNodeModel"
"Random Forest Learner",178,178,206754,1,1320,"0:21","org.knime.base.node.mine.treeensemble2.node.learner.classification.TreeEnsembleClassificationLearnerNodeModel"
"Random Forest Learner",178,178,206932,1,1321,"0:21","org.knime.base.node.mine.treeensemble2.node.learner.classification.TreeEnsembleClassificationLearnerNodeModel"
"Random Forest Learner",173,173,207105,1,1322,"0:21","org.knime.base.node.mine.treeensemble2.node.learner.classification.TreeEnsembleClassificationLearnerNodeModel"
"Random Forest Learner",191,191,207296,1,1323,"0:21","org.knime.base.node.mine.treeensemble2.node.learner.classification.TreeEnsembleClassificationLearnerNodeModel"
"Random Forest Learner",168,168,207464,1,1324,"0:21","org.knime.base.node.mine.treeensemble2.node.learner.classification.TreeEnsembleClassificationLearnerNodeModel"
"Random Forest Learner",170,170,207634,1,1325,"0:21","org.knime.base.node.mine.treeensemble2.node.learner.classification.TreeEnsembleClassificationLearnerNodeModel"
"Random Forest Learner",163,163,207797,1,1326,"0:21","org.knime.base.node.mine.treeensemble2.node.learner.classification.TreeEnsembleClassificationLearnerNodeModel"
"Random Forest Learner",172,172,207969,1,1327,"0:21","org.knime.base.node.mine.treeensemble2.node.learner.classification.TreeEnsembleClassificationLearnerNodeModel"
"Random Forest Learner",182,182,208151,1,1328,"0:21","org.knime.base.node.mine.treeensemble2.node.learner.classification.TreeEnsembleClassificationLearnerNodeModel"
"Random Forest Learner",165,165,208316,1,1329,"0:21","org.knime.base.node.mine.treeensemble2.node.learner.classification.TreeEnsembleClassificationLearnerNodeModel"
"Random Forest Learner",187,187,208503,1,1330,"0:21","org.knime.base.node.mine.treeensemble2.node.learner.classification.TreeEnsembleClassificationLearnerNodeModel"
"Random Forest Learner",168,168,208671,1,1331,"0:21","org.knime.base.node.mine.treeensemble2.node.learner.classification.TreeEnsembleClassificationLearnerNodeModel"
"Random Forest Learner",178,178,208849,1,1332,"0:21","org.knime.base.node.mine.treeensemble2.node.learner.classification.TreeEnsembleClassificationLearnerNodeModel"
"Random Forest Learner",173,173,209022,1,1333,"0:21","org.knime.base.node.mine.treeensemble2.node.learner.classification.TreeEnsembleClassificationLearnerNodeModel"
"Random Forest Learner",193,193,209215,1,1334,"0:21","org.knime.base.node.mine.treeensemble2.node.learner.classification.TreeEnsembleClassificationLearnerNodeModel"
"Random Forest Learner",173,173,209388,1,1335,"0:21","org.knime.base.node.mine.treeensemble2.node.learner.classification.TreeEnsembleClassificationLearnerNodeModel"
"Random Forest Learner",173,173,209561,1,1336,"0:21","org.knime.base.node.mine.treeensemble2.node.learner.classification.TreeEnsembleClassificationLearnerNodeModel"
"Random Forest Learner",175,175,209736,1,1337,"0:21","org.knime.base.node.mine.treeensemble2.node.learner.classification.TreeEnsembleClassificationLearnerNodeModel"
"Random Forest Learner",166,166,209902,1,1338,"0:21","org.knime.base.node.mine.treeensemble2.node.learner.classification.TreeEnsembleClassificationLearnerNodeModel"
"Random Forest Learner",190,190,210092,1,1339,"0:21","org.knime.base.node.mine.treeensemble2.node.learner.classification.TreeEnsembleClassificationLearnerNodeModel"
"Random Forest Learner",158,158,210250,1,1340,"0:21","org.knime.base.node.mine.treeensemble2.node.learner.classification.TreeEnsembleClassificationLearnerNodeModel"
"Random Forest Learner",192,192,210442,1,1341,"0:21","org.knime.base.node.mine.treeensemble2.node.learner.classification.TreeEnsembleClassificationLearnerNodeModel"
"Random Forest Learner",161,161,210603,1,1342,"0:21","org.knime.base.node.mine.treeensemble2.node.learner.classification.TreeEnsembleClassificationLearnerNodeModel"
"Random Forest Learner",187,187,210790,1,1343,"0:21","org.knime.base.node.mine.treeensemble2.node.learner.classification.TreeEnsembleClassificationLearnerNodeModel"
"Random Forest Learner",170,170,210960,1,1344,"0:21","org.knime.base.node.mine.treeensemble2.node.learner.classification.TreeEnsembleClassificationLearnerNodeModel"
"Random Forest Learner",187,187,211147,1,1345,"0:21","org.knime.base.node.mine.treeensemble2.node.learner.classification.TreeEnsembleClassificationLearnerNodeModel"
"Random Forest Learner",183,183,211330,1,1346,"0:21","org.knime.base.node.mine.treeensemble2.node.learner.classification.TreeEnsembleClassificationLearnerNodeModel"
"Random Forest Learner",183,183,211513,1,1347,"0:21","org.knime.base.node.mine.treeensemble2.node.learner.classification.TreeEnsembleClassificationLearnerNodeModel"
"Random Forest Learner",312,312,211825,1,1348,"0:21","org.knime.base.node.mine.treeensemble2.node.learner.classification.TreeEnsembleClassificationLearnerNodeModel"
"Random Forest Learner",179,179,212004,1,1349,"0:21","org.knime.base.node.mine.treeensemble2.node.learner.classification.TreeEnsembleClassificationLearnerNodeModel"
"Random Forest Learner",166,166,212170,1,1350,"0:21","org.knime.base.node.mine.treeensemble2.node.learner.classification.TreeEnsembleClassificationLearnerNodeModel"
"Random Forest Learner",164,164,212334,1,1351,"0:21","org.knime.base.node.mine.treeensemble2.node.learner.classification.TreeEnsembleClassificationLearnerNodeModel"
"Random Forest Learner",175,175,212509,1,1352,"0:21","org.knime.base.node.mine.treeensemble2.node.learner.classification.TreeEnsembleClassificationLearnerNodeModel"
"Random Forest Learner",162,162,212671,1,1353,"0:21","org.knime.base.node.mine.treeensemble2.node.learner.classification.TreeEnsembleClassificationLearnerNodeModel"
"Random Forest Learner",167,167,212838,1,1354,"0:21","org.knime.base.node.mine.treeensemble2.node.learner.classification.TreeEnsembleClassificationLearnerNodeModel"
"Random Forest Learner",163,163,213001,1,1355,"0:21","org.knime.base.node.mine.treeensemble2.node.learner.classification.TreeEnsembleClassificationLearnerNodeModel"
"Random Forest Learner",177,177,213178,1,1356,"0:21","org.knime.base.node.mine.treeensemble2.node.learner.classification.TreeEnsembleClassificationLearnerNodeModel"
"Random Forest Learner",179,179,213357,1,1357,"0:21","org.knime.base.node.mine.treeensemble2.node.learner.classification.TreeEnsembleClassificationLearnerNodeModel"
"Random Forest Learner",177,177,213534,1,1358,"0:21","org.knime.base.node.mine.treeensemble2.node.learner.classification.TreeEnsembleClassificationLearnerNodeModel"
"Random Forest Learner",176,176,213710,1,1359,"0:21","org.knime.base.node.mine.treeensemble2.node.learner.classification.TreeEnsembleClassificationLearnerNodeModel"
"Random Forest Learner",171,171,213881,1,1360,"0:21","org.knime.base.node.mine.treeensemble2.node.learner.classification.TreeEnsembleClassificationLearnerNodeModel"
"Random Forest Learner",176,176,214057,1,1361,"0:21","org.knime.base.node.mine.treeensemble2.node.learner.classification.TreeEnsembleClassificationLearnerNodeModel"
"Random Forest Learner",156,156,214213,1,1362,"0:21","org.knime.base.node.mine.treeensemble2.node.learner.classification.TreeEnsembleClassificationLearnerNodeModel"
"Random Forest Learner",163,163,214376,1,1363,"0:21","org.knime.base.node.mine.treeensemble2.node.learner.classification.TreeEnsembleClassificationLearnerNodeModel"
"Random Forest Learner",178,178,214554,1,1364,"0:21","org.knime.base.node.mine.treeensemble2.node.learner.classification.TreeEnsembleClassificationLearnerNodeModel"
"Random Forest Learner",163,163,214717,1,1365,"0:21","org.knime.base.node.mine.treeensemble2.node.learner.classification.TreeEnsembleClassificationLearnerNodeModel"
"Random Forest Learner",179,179,214896,1,1366,"0:21","org.knime.base.node.mine.treeensemble2.node.learner.classification.TreeEnsembleClassificationLearnerNodeModel"
"Random Forest Learner",174,174,215070,1,1367,"0:21","org.knime.base.node.mine.treeensemble2.node.learner.classification.TreeEnsembleClassificationLearnerNodeModel"
"Random Forest Learner",169,169,215239,1,1368,"0:21","org.knime.base.node.mine.treeensemble2.node.learner.classification.TreeEnsembleClassificationLearnerNodeModel"
"Random Forest Learner",151,151,215390,1,1369,"0:21","org.knime.base.node.mine.treeensemble2.node.learner.classification.TreeEnsembleClassificationLearnerNodeModel"
"Random Forest Learner",174,174,215564,1,1370,"0:21","org.knime.base.node.mine.treeensemble2.node.learner.classification.TreeEnsembleClassificationLearnerNodeModel"
"Random Forest Learner",156,156,215720,1,1371,"0:21","org.knime.base.node.mine.treeensemble2.node.learner.classification.TreeEnsembleClassificationLearnerNodeModel"
"Random Forest Learner",166,166,215886,1,1372,"0:21","org.knime.base.node.mine.treeensemble2.node.learner.classification.TreeEnsembleClassificationLearnerNodeModel"
"Random Forest Learner",146,146,216032,1,1373,"0:21","org.knime.base.node.mine.treeensemble2.node.learner.classification.TreeEnsembleClassificationLearnerNodeModel"
"Random Forest Learner",159,159,216191,1,1374,"0:21","org.knime.base.node.mine.treeensemble2.node.learner.classification.TreeEnsembleClassificationLearnerNodeModel"
"Random Forest Learner",152,152,216343,1,1375,"0:21","org.knime.base.node.mine.treeensemble2.node.learner.classification.TreeEnsembleClassificationLearnerNodeModel"
"Random Forest Learner",147,147,216490,1,1376,"0:21","org.knime.base.node.mine.treeensemble2.node.learner.classification.TreeEnsembleClassificationLearnerNodeModel"
"Random Forest Learner",150,150,216640,1,1377,"0:21","org.knime.base.node.mine.treeensemble2.node.learner.classification.TreeEnsembleClassificationLearnerNodeModel"
"Random Forest Learner",144,144,216784,1,1378,"0:21","org.knime.base.node.mine.treeensemble2.node.learner.classification.TreeEnsembleClassificationLearnerNodeModel"
"Random Forest Learner",143,143,216927,1,1379,"0:21","org.knime.base.node.mine.treeensemble2.node.learner.classification.TreeEnsembleClassificationLearnerNodeModel"
"Random Forest Learner",167,167,217094,1,1380,"0:21","org.knime.base.node.mine.treeensemble2.node.learner.classification.TreeEnsembleClassificationLearnerNodeModel"
"Random Forest Learner",145,145,217239,1,1381,"0:21","org.knime.base.node.mine.treeensemble2.node.learner.classification.TreeEnsembleClassificationLearnerNodeModel"
"Random Forest Learner",150,150,217389,1,1382,"0:21","org.knime.base.node.mine.treeensemble2.node.learner.classification.TreeEnsembleClassificationLearnerNodeModel"
"Random Forest Learner",154,154,217543,1,1383,"0:21","org.knime.base.node.mine.treeensemble2.node.learner.classification.TreeEnsembleClassificationLearnerNodeModel"
"Random Forest Learner",146,146,217689,1,1384,"0:21","org.knime.base.node.mine.treeensemble2.node.learner.classification.TreeEnsembleClassificationLearnerNodeModel"
"Random Forest Learner",147,147,217836,1,1385,"0:21","org.knime.base.node.mine.treeensemble2.node.learner.classification.TreeEnsembleClassificationLearnerNodeModel"
"Random Forest Learner",134,134,217970,1,1386,"0:21","org.knime.base.node.mine.treeensemble2.node.learner.classification.TreeEnsembleClassificationLearnerNodeModel"
"Random Forest Learner",147,147,218117,1,1387,"0:21","org.knime.base.node.mine.treeensemble2.node.learner.classification.TreeEnsembleClassificationLearnerNodeModel"
"Random Forest Learner",147,147,218264,1,1388,"0:21","org.knime.base.node.mine.treeensemble2.node.learner.classification.TreeEnsembleClassificationLearnerNodeModel"
"Random Forest Learner",134,134,218398,1,1389,"0:21","org.knime.base.node.mine.treeensemble2.node.learner.classification.TreeEnsembleClassificationLearnerNodeModel"
"Random Forest Learner",162,162,218560,1,1390,"0:21","org.knime.base.node.mine.treeensemble2.node.learner.classification.TreeEnsembleClassificationLearnerNodeModel"
"Random Forest Learner",154,154,218714,1,1391,"0:21","org.knime.base.node.mine.treeensemble2.node.learner.classification.TreeEnsembleClassificationLearnerNodeModel"
"Random Forest Learner",136,136,218850,1,1392,"0:21","org.knime.base.node.mine.treeensemble2.node.learner.classification.TreeEnsembleClassificationLearnerNodeModel"
"Random Forest Learner",163,163,219013,1,1393,"0:21","org.knime.base.node.mine.treeensemble2.node.learner.classification.TreeEnsembleClassificationLearnerNodeModel"
"Random Forest Learner",145,145,219158,1,1394,"0:21","org.knime.base.node.mine.treeensemble2.node.learner.classification.TreeEnsembleClassificationLearnerNodeModel"
"Random Forest Learner",150,150,219308,1,1395,"0:21","org.knime.base.node.mine.treeensemble2.node.learner.classification.TreeEnsembleClassificationLearnerNodeModel"
"Random Forest Learner",139,139,219447,1,1396,"0:21","org.knime.base.node.mine.treeensemble2.node.learner.classification.TreeEnsembleClassificationLearnerNodeModel"
"Random Forest Learner",151,151,219598,1,1397,"0:21","org.knime.base.node.mine.treeensemble2.node.learner.classification.TreeEnsembleClassificationLearnerNodeModel"
"Random Forest Learner",149,149,219747,1,1398,"0:21","org.knime.base.node.mine.treeensemble2.node.learner.classification.TreeEnsembleClassificationLearnerNodeModel"
"Random Forest Learner",142,142,219889,1,1399,"0:21","org.knime.base.node.mine.treeensemble2.node.learner.classification.TreeEnsembleClassificationLearnerNodeModel"
"Random Forest Learner",168,168,220057,1,1400,"0:21","org.knime.base.node.mine.treeensemble2.node.learner.classification.TreeEnsembleClassificationLearnerNodeModel"
"Random Forest Learner",147,147,220204,1,1401,"0:21","org.knime.base.node.mine.treeensemble2.node.learner.classification.TreeEnsembleClassificationLearnerNodeModel"
"Random Forest Learner",143,143,220347,1,1402,"0:21","org.knime.base.node.mine.treeensemble2.node.learner.classification.TreeEnsembleClassificationLearnerNodeModel"
"Random Forest Learner",158,158,220505,1,1403,"0:21","org.knime.base.node.mine.treeensemble2.node.learner.classification.TreeEnsembleClassificationLearnerNodeModel"
"Random Forest Learner",152,152,220657,1,1404,"0:21","org.knime.base.node.mine.treeensemble2.node.learner.classification.TreeEnsembleClassificationLearnerNodeModel"
"Random Forest Learner",147,147,220804,1,1405,"0:21","org.knime.base.node.mine.treeensemble2.node.learner.classification.TreeEnsembleClassificationLearnerNodeModel"
"Random Forest Learner",132,132,220936,1,1406,"0:21","org.knime.base.node.mine.treeensemble2.node.learner.classification.TreeEnsembleClassificationLearnerNodeModel"
"Random Forest Learner",140,140,221076,1,1407,"0:21","org.knime.base.node.mine.treeensemble2.node.learner.classification.TreeEnsembleClassificationLearnerNodeModel"
"Random Forest Learner",148,148,221224,1,1408,"0:21","org.knime.base.node.mine.treeensemble2.node.learner.classification.TreeEnsembleClassificationLearnerNodeModel"
"Random Forest Learner",142,142,221366,1,1409,"0:21","org.knime.base.node.mine.treeensemble2.node.learner.classification.TreeEnsembleClassificationLearnerNodeModel"
"Random Forest Learner",169,169,221535,1,1410,"0:21","org.knime.base.node.mine.treeensemble2.node.learner.classification.TreeEnsembleClassificationLearnerNodeModel"
"Random Forest Learner",146,146,221681,1,1411,"0:21","org.knime.base.node.mine.treeensemble2.node.learner.classification.TreeEnsembleClassificationLearnerNodeModel"
"Random Forest Learner",132,132,221813,1,1412,"0:21","org.knime.base.node.mine.treeensemble2.node.learner.classification.TreeEnsembleClassificationLearnerNodeModel"
"Random Forest Learner",172,172,221985,1,1413,"0:21","org.knime.base.node.mine.treeensemble2.node.learner.classification.TreeEnsembleClassificationLearnerNodeModel"
"Random Forest Learner",147,147,222132,1,1414,"0:21","org.knime.base.node.mine.treeensemble2.node.learner.classification.TreeEnsembleClassificationLearnerNodeModel"
"Random Forest Learner",140,140,222272,1,1415,"0:21","org.knime.base.node.mine.treeensemble2.node.learner.classification.TreeEnsembleClassificationLearnerNodeModel"
"Random Forest Learner",150,150,222422,1,1416,"0:21","org.knime.base.node.mine.treeensemble2.node.learner.classification.TreeEnsembleClassificationLearnerNodeModel"
"Random Forest Learner",150,150,222572,1,1417,"0:21","org.knime.base.node.mine.treeensemble2.node.learner.classification.TreeEnsembleClassificationLearnerNodeModel"
"Random Forest Learner",152,152,222724,1,1418,"0:21","org.knime.base.node.mine.treeensemble2.node.learner.classification.TreeEnsembleClassificationLearnerNodeModel"
"Random Forest Learner",142,142,222866,1,1419,"0:21","org.knime.base.node.mine.treeensemble2.node.learner.classification.TreeEnsembleClassificationLearnerNodeModel"
"Random Forest Learner",166,166,223032,1,1420,"0:21","org.knime.base.node.mine.treeensemble2.node.learner.classification.TreeEnsembleClassificationLearnerNodeModel"
"Random Forest Learner",151,151,223183,1,1421,"0:21","org.knime.base.node.mine.treeensemble2.node.learner.classification.TreeEnsembleClassificationLearnerNodeModel"
"Random Forest Learner",142,142,223325,1,1422,"0:21","org.knime.base.node.mine.treeensemble2.node.learner.classification.TreeEnsembleClassificationLearnerNodeModel"
"Random Forest Learner",166,166,223491,1,1423,"0:21","org.knime.base.node.mine.treeensemble2.node.learner.classification.TreeEnsembleClassificationLearnerNodeModel"
"Random Forest Learner",163,163,223654,1,1424,"0:21","org.knime.base.node.mine.treeensemble2.node.learner.classification.TreeEnsembleClassificationLearnerNodeModel"
"Random Forest Learner",147,147,223801,1,1425,"0:21","org.knime.base.node.mine.treeensemble2.node.learner.classification.TreeEnsembleClassificationLearnerNodeModel"
"Random Forest Learner",132,132,223933,1,1426,"0:21","org.knime.base.node.mine.treeensemble2.node.learner.classification.TreeEnsembleClassificationLearnerNodeModel"
"Random Forest Learner",143,143,224076,1,1427,"0:21","org.knime.base.node.mine.treeensemble2.node.learner.classification.TreeEnsembleClassificationLearnerNodeModel"
"Random Forest Learner",142,142,224218,1,1428,"0:21","org.knime.base.node.mine.treeensemble2.node.learner.classification.TreeEnsembleClassificationLearnerNodeModel"
"Random Forest Learner",150,150,224368,1,1429,"0:21","org.knime.base.node.mine.treeensemble2.node.learner.classification.TreeEnsembleClassificationLearnerNodeModel"
"Random Forest Learner",160,160,224528,1,1430,"0:21","org.knime.base.node.mine.treeensemble2.node.learner.classification.TreeEnsembleClassificationLearnerNodeModel"
"Random Forest Learner",154,154,224682,1,1431,"0:21","org.knime.base.node.mine.treeensemble2.node.learner.classification.TreeEnsembleClassificationLearnerNodeModel"
"Random Forest Learner",148,148,224830,1,1432,"0:21","org.knime.base.node.mine.treeensemble2.node.learner.classification.TreeEnsembleClassificationLearnerNodeModel"
"Random Forest Learner",169,169,224999,1,1433,"0:21","org.knime.base.node.mine.treeensemble2.node.learner.classification.TreeEnsembleClassificationLearnerNodeModel"
"Random Forest Learner",143,143,225142,1,1434,"0:21","org.knime.base.node.mine.treeensemble2.node.learner.classification.TreeEnsembleClassificationLearnerNodeModel"
"Random Forest Learner",135,135,225277,1,1435,"0:21","org.knime.base.node.mine.treeensemble2.node.learner.classification.TreeEnsembleClassificationLearnerNodeModel"
"Random Forest Learner",134,134,225411,1,1436,"0:21","org.knime.base.node.mine.treeensemble2.node.learner.classification.TreeEnsembleClassificationLearnerNodeModel"
"Random Forest Learner",146,146,225557,1,1437,"0:21","org.knime.base.node.mine.treeensemble2.node.learner.classification.TreeEnsembleClassificationLearnerNodeModel"
"Random Forest Learner",147,147,225704,1,1438,"0:21","org.knime.base.node.mine.treeensemble2.node.learner.classification.TreeEnsembleClassificationLearnerNodeModel"
"Random Forest Learner",136,136,225840,1,1439,"0:21","org.knime.base.node.mine.treeensemble2.node.learner.classification.TreeEnsembleClassificationLearnerNodeModel"
"Random Forest Learner",174,174,226014,1,1440,"0:21","org.knime.base.node.mine.treeensemble2.node.learner.classification.TreeEnsembleClassificationLearnerNodeModel"
"Random Forest Learner",159,159,226173,1,1441,"0:21","org.knime.base.node.mine.treeensemble2.node.learner.classification.TreeEnsembleClassificationLearnerNodeModel"
"Random Forest Learner",148,148,226321,1,1442,"0:21","org.knime.base.node.mine.treeensemble2.node.learner.classification.TreeEnsembleClassificationLearnerNodeModel"
"Random Forest Learner",169,169,226490,1,1443,"0:21","org.knime.base.node.mine.treeensemble2.node.learner.classification.TreeEnsembleClassificationLearnerNodeModel"
"Random Forest Learner",157,157,226647,1,1444,"0:21","org.knime.base.node.mine.treeensemble2.node.learner.classification.TreeEnsembleClassificationLearnerNodeModel"
"Random Forest Learner",153,153,226800,1,1445,"0:21","org.knime.base.node.mine.treeensemble2.node.learner.classification.TreeEnsembleClassificationLearnerNodeModel"
"Random Forest Learner",178,178,226978,1,1446,"0:21","org.knime.base.node.mine.treeensemble2.node.learner.classification.TreeEnsembleClassificationLearnerNodeModel"
"Random Forest Learner",161,161,227139,1,1447,"0:21","org.knime.base.node.mine.treeensemble2.node.learner.classification.TreeEnsembleClassificationLearnerNodeModel"
"Random Forest Learner",155,155,227294,1,1448,"0:21","org.knime.base.node.mine.treeensemble2.node.learner.classification.TreeEnsembleClassificationLearnerNodeModel"
"Random Forest Learner",159,159,227453,1,1449,"0:21","org.knime.base.node.mine.treeensemble2.node.learner.classification.TreeEnsembleClassificationLearnerNodeModel"
"Random Forest Learner",158,158,227611,1,1450,"0:21","org.knime.base.node.mine.treeensemble2.node.learner.classification.TreeEnsembleClassificationLearnerNodeModel"
"Random Forest Learner",169,169,227780,1,1451,"0:21","org.knime.base.node.mine.treeensemble2.node.learner.classification.TreeEnsembleClassificationLearnerNodeModel"
"Random Forest Learner",151,151,227931,1,1452,"0:21","org.knime.base.node.mine.treeensemble2.node.learner.classification.TreeEnsembleClassificationLearnerNodeModel"
"Random Forest Learner",157,157,228088,1,1453,"0:21","org.knime.base.node.mine.treeensemble2.node.learner.classification.TreeEnsembleClassificationLearnerNodeModel"
"Random Forest Learner",172,172,228260,1,1454,"0:21","org.knime.base.node.mine.treeensemble2.node.learner.classification.TreeEnsembleClassificationLearnerNodeModel"
"Random Forest Learner",150,150,228410,1,1455,"0:21","org.knime.base.node.mine.treeensemble2.node.learner.classification.TreeEnsembleClassificationLearnerNodeModel"
"Random Forest Learner",193,193,228603,1,1456,"0:21","org.knime.base.node.mine.treeensemble2.node.learner.classification.TreeEnsembleClassificationLearnerNodeModel"
"Random Forest Learner",163,163,228766,1,1457,"0:21","org.knime.base.node.mine.treeensemble2.node.learner.classification.TreeEnsembleClassificationLearnerNodeModel"
"Random Forest Learner",167,167,228933,1,1458,"0:21","org.knime.base.node.mine.treeensemble2.node.learner.classification.TreeEnsembleClassificationLearnerNodeModel"
"Random Forest Learner",201,201,229134,1,1459,"0:21","org.knime.base.node.mine.treeensemble2.node.learner.classification.TreeEnsembleClassificationLearnerNodeModel"
"Random Forest Learner",175,175,229309,1,1460,"0:21","org.knime.base.node.mine.treeensemble2.node.learner.classification.TreeEnsembleClassificationLearnerNodeModel"
"Random Forest Learner",165,165,229474,1,1461,"0:21","org.knime.base.node.mine.treeensemble2.node.learner.classification.TreeEnsembleClassificationLearnerNodeModel"
"Random Forest Learner",193,193,229667,1,1462,"0:21","org.knime.base.node.mine.treeensemble2.node.learner.classification.TreeEnsembleClassificationLearnerNodeModel"
"Random Forest Learner",178,178,229845,1,1463,"0:21","org.knime.base.node.mine.treeensemble2.node.learner.classification.TreeEnsembleClassificationLearnerNodeModel"
"Random Forest Learner",172,172,230017,1,1464,"0:21","org.knime.base.node.mine.treeensemble2.node.learner.classification.TreeEnsembleClassificationLearnerNodeModel"
"Random Forest Learner",194,194,230211,1,1465,"0:21","org.knime.base.node.mine.treeensemble2.node.learner.classification.TreeEnsembleClassificationLearnerNodeModel"
"Random Forest Learner",179,179,230390,1,1466,"0:21","org.knime.base.node.mine.treeensemble2.node.learner.classification.TreeEnsembleClassificationLearnerNodeModel"
"Random Forest Learner",170,170,230560,1,1467,"0:21","org.knime.base.node.mine.treeensemble2.node.learner.classification.TreeEnsembleClassificationLearnerNodeModel"
"Random Forest Learner",197,197,230757,1,1468,"0:21","org.knime.base.node.mine.treeensemble2.node.learner.classification.TreeEnsembleClassificationLearnerNodeModel"
"Random Forest Learner",176,176,230933,1,1469,"0:21","org.knime.base.node.mine.treeensemble2.node.learner.classification.TreeEnsembleClassificationLearnerNodeModel"
"Random Forest Learner",175,175,231108,1,1470,"0:21","org.knime.base.node.mine.treeensemble2.node.learner.classification.TreeEnsembleClassificationLearnerNodeModel"
"Random Forest Learner",193,193,231301,1,1471,"0:21","org.knime.base.node.mine.treeensemble2.node.learner.classification.TreeEnsembleClassificationLearnerNodeModel"
"Random Forest Learner",178,178,231479,1,1472,"0:21","org.knime.base.node.mine.treeensemble2.node.learner.classification.TreeEnsembleClassificationLearnerNodeModel"
"Random Forest Learner",170,170,231649,1,1473,"0:21","org.knime.base.node.mine.treeensemble2.node.learner.classification.TreeEnsembleClassificationLearnerNodeModel"
"Random Forest Learner",196,196,231845,1,1474,"0:21","org.knime.base.node.mine.treeensemble2.node.learner.classification.TreeEnsembleClassificationLearnerNodeModel"
"Random Forest Learner",176,176,232021,1,1475,"0:21","org.knime.base.node.mine.treeensemble2.node.learner.classification.TreeEnsembleClassificationLearnerNodeModel"
"Random Forest Learner",178,178,232199,1,1476,"0:21","org.knime.base.node.mine.treeensemble2.node.learner.classification.TreeEnsembleClassificationLearnerNodeModel"
"Random Forest Learner",190,190,232389,1,1477,"0:21","org.knime.base.node.mine.treeensemble2.node.learner.classification.TreeEnsembleClassificationLearnerNodeModel"
"Random Forest Learner",183,183,232572,1,1478,"0:21","org.knime.base.node.mine.treeensemble2.node.learner.classification.TreeEnsembleClassificationLearnerNodeModel"
"Random Forest Learner",184,184,232756,1,1479,"0:21","org.knime.base.node.mine.treeensemble2.node.learner.classification.TreeEnsembleClassificationLearnerNodeModel"